"filename", "language", "Rust", "TOML", "comment", "blank", "total"
"/home/andrew/Documents/GitHub/daw/Cargo.toml", "TOML", 0, 12, 1, 3, 16
"/home/andrew/Documents/GitHub/daw/src/lib.rs", "Rust", 7, 0, 0, 1, 8
"/home/andrew/Documents/GitHub/daw/src/main.rs", "Rust", 6, 0, 12, 4, 22
"/home/andrew/Documents/GitHub/daw/src/note_freqs.rs", "Rust", 108, 0, 0, 0, 108
"/home/andrew/Documents/GitHub/daw/src/project.rs", "Rust", 129, 0, 3, 42, 174
"/home/andrew/Documents/GitHub/daw/src/project/time.rs", "Rust", 14, 0, 0, 3, 17
"/home/andrew/Documents/GitHub/daw/src/project/track.rs", "Rust", 117, 0, 0, 13, 130
"/home/andrew/Documents/GitHub/daw/src/project/track/effect.rs", "Rust", 50, 0, 0, 7, 57
"/home/andrew/Documents/GitHub/daw/src/project/track/midi.rs", "Rust", 54, 0, 0, 7, 61
"/home/andrew/Documents/GitHub/daw/src/project/track/midi/dynamics.rs", "Rust", 31, 0, 0, 2, 33
"/home/andrew/Documents/GitHub/daw/src/project/track/midi/instrument.rs", "Rust", 6, 0, 0, 1, 7
"/home/andrew/Documents/GitHub/daw/src/project/track/midi/note.rs", "Rust", 10, 0, 0, 2, 12
"/home/andrew/Documents/GitHub/daw/src/project/track/midi/pitch.rs", "Rust", 107, 0, 0, 11, 118
"/home/andrew/Documents/GitHub/daw/src/project/track/midi/toml.rs", "Rust", 93, 0, 0, 25, 118
"/home/andrew/Documents/GitHub/daw/src/project/track/raw_samples.rs", "Rust", 99, 0, 6, 12, 117
"/home/andrew/Documents/GitHub/daw/src/project/track/raw_samples/basic_waveforms.rs", "Rust", 85, 0, 12, 11, 108
"/home/andrew/Documents/GitHub/daw/src/project/track/raw_samples/channels.rs", "Rust", 9, 0, 0, 1, 10
"/home/andrew/Documents/GitHub/daw/src/project/track/raw_samples/fade.rs", "Rust", 63, 0, 3, 7, 73
"/home/andrew/Documents/GitHub/daw/src/project/track/raw_samples/modifiers.rs", "Rust", 79, 0, 6, 25, 110
"/home/andrew/Documents/GitHub/daw/src/project/track/raw_samples/modulators.rs", "Rust", 9, 0, 6, 1, 16
"/home/andrew/Documents/GitHub/daw/src/project/track/raw_samples/reverb.rs", "Rust", 70, 0, 4, 19, 93
"/home/andrew/Documents/GitHub/daw/src/project/track/raw_samples/timbres.rs", "Rust", 59, 0, 7, 8, 74
"/home/andrew/Documents/GitHub/daw/src/project/track/score.rs", "Rust", 45, 0, 0, 5, 50
"/home/andrew/Documents/GitHub/daw/src/project/track_type.rs", "Rust", 8, 0, 0, 0, 8
"/home/andrew/Documents/GitHub/daw/src/project/wav_settings.rs", "Rust", 21, 0, 0, 3, 24
"/home/andrew/Documents/GitHub/daw/src/project/wav_writer.rs", "Rust", 79, 0, 1, 17, 97
"/home/andrew/Documents/GitHub/daw/src/project/wav_writer/format.rs", "Rust", 135, 0, 0, 33, 168
"/home/andrew/Documents/GitHub/daw/src/project/wav_writer/raw_sample_writer.rs", "Rust", 81, 0, 6, 22, 109
"/home/andrew/Documents/GitHub/daw/src/project/wav_writer/resample.rs", "Rust", 22, 0, 0, 4, 26
"/home/andrew/Documents/GitHub/daw/src/project/wav_writer/sample_conversion.rs", "Rust", 54, 0, 0, 18, 72
"/home/andrew/Documents/GitHub/daw/src/project/wave.rs", "Rust", 6, 0, 0, 0, 6
"/home/andrew/Documents/GitHub/daw/src/project/waveform.rs", "Rust", 13, 0, 0, 3, 16
"/home/andrew/Documents/GitHub/daw/src/tests.rs", "Rust", 2, 0, 0, 0, 2
"/home/andrew/Documents/GitHub/daw/src/tests/misc_tests.rs", "Rust", 43, 0, 0, 13, 56
"/home/andrew/Documents/GitHub/daw/src/tests/unit_tests.rs", "Rust", 49, 0, 17, 12, 78
"Total", "-", 1763, 12, 84, 335, 2194